.#........
..#.##.##.
#.#...#...
..#.###.#.
.#.....#..
#....##...
#.#.#.#...
..#.##....
.........#
.##..#..#
